11111111111111
1P001C11C100C1
11000000000011
10010000001111
1C011C00C000E1
11111111111111